64 24
1000000000000000000000000000000000000000000000000000000000000001
1000000000000000000000000000000000000000000000000000000000000001
1000000000000000000000000000000000000000000000*00000000000000001
1000000111117111111111110000000000000000000011810000000000000001
1111111100060000000000111100000000000000181100800000014111111111
1000000000600000000000011111111111111711080000800000000300000001
1000000006000000000000001000000000006000080000800000000030000001
1114111151000000000000001000000000060000080111110000000003000001
1000300000000000011100001000000000600001111110000000000000300001
1000030000000000010100001111117115111111111110001111111117121111
1000003000000000100100000000060000001111111111110000000060000001
1001111211111171111100000000600000001100000000000000000600000001
10000000000006001111000*0006000000001100000000000000006000000001
100000000000600001110011415100000000110000*000000000060000000001
1000000000060000001100000300000000001111111111110000600000000001
1000000000600000000000000030000000000011111111110006000000000001
1000114115110000000000000003000000000000000000110060000000000001
1000000300000011000000000001211114110000000000111511111117111111
1000000030000000111117100000000000300000000000000000000060000001
1111000003000000000060000000000000030000000000000000000600000001
1111110000300000000600000000000000003000000000000000006000000001
1111111111121100006000011111111111111211111111111111151111111111
1111111111111111151111111111111111111111111111111111111111111111
8888888888888888888888888888888888888888888888888888888888888888