32 24
10000000000000000000000000000001
10000000000000000000000000000001
10*00011111111111111111111000*01
11141110000000000000000001117111
10003000000000000000000000060001
10000300000000000000000000600001
10000030000000000000000006000001
11141112111000000000000151117111
10003000000000000000000000060001
10000300000000000000000000600001
10000030000000000000000006000001
10000003000000000000000060000001
10000111211171188114111511111001
10000000000600000000300000010001
10000000006000000000030000010001
10000000060000000000003000010*01
10001141511000000000011217111111
10000003000000000000000060000001
10000000300000111100000600000001
10000000030000000000006000000001
11010000003000000000060000000001
10*11100000300000000600000000111
11111111111121111115111111111111
88888888888888888888888888888888