32 24
10000000000000000000000000000001
10000000000000000000000000000001
1000*000000000000000000000000001
11111111114111111111111110000*01
10000000000300000000000011117111
10000000000030000000000000060001
10000000000003000000000000600001
100*0000000000300000000006000001
11111411111100030000001151117111
11010030000000003000000000060001
11110003000000000300000000600001
11110000300000000030000006000001
10000000030000001112148851111001
10000000003000001100003000000001
10000000011211111100000300000001
11111111100000000000000030000001
10000000100000000000000003000001
10000000100000000000117111210001
10000000111111000000060000000001
10000000000000000000600000000001
10011100000000000006000000000111
1*011100000000001151111111111111
11111111111111111111111111111111
88888888888888888888888888888888